................
.##############.
.#!abc!!#!abc!#.
.#!dxe!!#!dxe!#.
.#ooooo*# )@( #.
.#*ooooo#  ####.
.#   ####  !!!#.
.#   !!!#~~!!!#.
.#   !!!#~~~~~#.
.#      ###.~~#.
.#*     !!!..~#.
.#**~~~~!!!.~~#.
.~oooooooooo(*#.
..~G~~~....~**#.
...~~.......###.
................