................
....###########.
....!!!!!!abc!#.
....!!!!!!dxe!#.
...~~~.~~~~@~*#.
.*G~.~~~.~.~.~#.
.#######.~~.~.#.
.......###~~.~#.
.........#.~~~*.
.#########~.~.~.
.#!abc!!!!.~~...
.#!dxe!!!!~.~~..
.#*~~~...~...~~.
.#~.~~.~~~.~.~..
.##~.~~~.~~~~~..
................