................
.#######........
.#!abc!#........
.#!dxe!#........
.#~~~~~###......
....~..!!#......
....~..!!######.
....~..~~!abc!#.
....~~..~!dxe!#.
.....~..~~~@~~#.
.....~~~~~~~....
.......~~~~.....
.........~~~....
.........~~~~G..
................
................