################
#!abc!!B  !abc!#
#!dxe!!   !dxe!#
#*)@ooooGo~~~(*#
#~~~~~~~~~~~~~~#
#~~~~~~~~~~~~~~#
#~~~~~~~~~~~~~~#
#~~~~~~~~~~~~~~#
#~~~~~~~~~~~~~~#
#~~~~~~~~~~~~~~#
#~~~~~~~~~~~~~~#
#~~~~~~~~~~~~~~#
#~~~~~~~~~~~~~~#
#~~~~~~~~~~~~**#
#*~~~~~~~~~***L#
################